000208000
003050060
900007080
200003009
085000210
700500004
070300001
040090300
000402000