000008020
070000408
500000000
200000054
600050000
900010600
001803000
869000007
000004090