000010060
000976005
000300140
573000900
800000007
004000283
048007000
600598000
050020000