000090007
000200004
002340190
008003001
090070050
600500400
075024800
400001000
300050000