000006090
001070004
005021070
050004018
004000300
180500060
040130600
500080900
090200000