900041000
800620001
000005006
050307000
004000060
781000500
003200007
000000400
072000000