000214700
004000050
020053008
090100307
050000802
001008005
700560080
040000500
005479000