000082005
500000070
000310002
000007540
760000098
083100000
300041000
090000004
800670000