126000790
004000001
000003000
908060070
000307000
060010802
000200000
800000900
092000416