005200000
600810500
802503010
004080051
000007000
000004360
000090020
008000040
329000000