000000900
004090756
007000204
203104090
000708000
070902308
905000400
632070800
008000000