000006004
900407500
800900031
015000003
000060000
400000120
530002008
004603005
200800000