001000200
009006081
875021000
010009000
750000032
000500010
000930046
630200100
097000300