000489050
040100200
000000078
007024903
000000000
604590800
780000000
003008090
060372000