023090008
901004000
000007001
008000039
000020000
490000100
600500000
000600704
800030250