007300605
060000000
908006001
004900702
000010000
102005300
200600504
000000030
305009100