723190008
901004000
500007001
208001039
130920007
490803100
600500013
350610704
810039256