010000090
200000006
000136000
008000400
090207050
001000300
000894000
600000007
050000020