000000040
024000900
080107630
000071000
097605480
000480000
013208050
006000810
070000000