005390070
060800000
000602500
007000061
630700000
940000000
000020900
003010080
800503200