503100002
100043900
000000700
060009020
005070600
080400050
009000000
002380006
800002304