200370000
500000000
000001260
009017030
010000050
600200080
080000070
005000024
093060500