009700510
410000000
600093000
800006700
500402001
006300002
000830004
000000075
034005600